NO xpm/Akatsuki.xpm
SO xpm/mangigue.xpm
WE xpm/tsakiumi.xpm
EA xpm/uchiha.xpm
F  255,255,255
C 0,255,0


111111111111111111111111111111111111111111111111111111111111
1000N0000001000000000000000000000000000000000000000000000001
100000000000000000000000000000000000000000000000000000000001
100000000000000000000010000000000000000000000000000000000001
100000000000000000000010000000000000000000000000000000000001
100000000000000000000010000000000000000000000000000000000001
100000000000000000000010000000000000000000000000000000000001
100000000000000000000010000000000000000000000000000000000001
100000000000000000000000010000000000000000000000000000000001
100000000000000000000000000000000000000000000000000000000001
100000000000000000000000000000000000000000000000000000000001
100000000000000000000000000000000000000000000000000000000001
100000000000000000000000000000000000000000000000000000000001
111111111111111111111111111111111111111111111111111111111111
