NO xpm/Akatsuki.xpm
SO xpm/mangigue.xpm
WE xpm/tsakiumi.xpm
EA xpm/uchiha.xpm
F  20,30,10
C 0,255,255



1111111111
10000W0001
1000000001
1111111111