NO xpm/Akatsuki.xpm
SO xpm/mangigue.xpm
WE xpm/tsakiumi.xpm
EA xpm/uchiha.xpm
F  20,30,10
C 0,255,255

111111111111111
111111000111111
111110000011111
1111000N0001111
111000010000111
110000100000011
100001111100001
110000111000011
111000010000111
111100000001111
111110000011111
111111000111111
111111111111111
